..............
..........A...
..... ........
....    ......
....     .....
....      ....
...       ....
...       ....
...     ......
.....  .......
S.............
