............................S
...............
.............................
            ..................
.................
                 ............
....................
.............................
........................A....
               ..............
