.......X.......
..S....X...A...
.......X.......
.......X.......
.......X.......
.......X.......
.......X.......
...............
